although - хотя
allocate - выделять
allow - позволять, разрешить
among - среди
assume - считать
available - доступ
awesome - потрясающий
baked - внедрение
blob - блок 
case - случай
complex - сложность
comprise - содержать
composed - состоять 
consequently - следовательно
constantly - постоянно
confirm - подтвердить
consider - учитывать
content - содержание
cover - получить, охватывать
current - текущий
currently - настоящий
defines - определять
deploy - развернуть
directly - напрямую 
discusse - обсуждать
during - происходить
each - каждый
especially - особенность
enough - достаточно
environment - среда
even - даже
exactly - именно
executable - исполняемый
existing - существующие
exit - выходить
external - внешний
flat - прозрачный
full-fledged - полноценный
handeler - обработчик
immediate - сразу
impressive - впечатляющий
incredibly - невероятно
include - включать
inside - внутри
instead - вместо этого
introduction - сведения
isolated - изолированный
itself - самостоятельный
keen - острый
keep - держаться
leave - опустить
list - перечислить
look - выглядеть
multi-node - многоузловой
multiple - несколько
necessary - обязательно
node - узел
nonced - обратить
once - после того
oven - даже
override - переопределить
own - собственный
path - путь
perform - выполнять
point - указывать
prove - доказывать
providу - предоставлять
pulled - извлечение
push - переместить
pushing - отправка
reffering - ссылаться
registry - хранилище
requier - требовать
roughly - грубо говоря
respond - отвечать
scale - масштабирование
sequence - последовательность
sharing - совместное использование
shorthand - сокращениие
single - единственный
single-node - одноузловой
somebody - кто-то
spans - охватывать
specity - указать
suggest - предлагать
topic - тема
truly - действительно
under - под
unfamiliar - незнаком
uploaded - закачивается
way - способ
